FIR = "countries/Fire Nation.txt"
NWT = "countries/Northern Water Tribe.txt"
SWT = "countries/Southern Water Tribe.txt"
NAT = "countries/Northern Air Temple.txt"
EAT = "countries/Eastern Air Temple.txt"
SAT = "countries/Southern Air Temple.txt"
WAT = "countries/Western Air Temple.txt"
SNW = "countries/Sun Warriors.txt"

EAR = "countries/Earth Kingdom.txt"
KYI = "countries/Kyoshi Island.txt"
OMS = "countries/Omashu.txt"
GAO = "countries/Gaoling.txt"
POH = "countries/Pohuai.txt"
TAK = "countries/Taku.txt"
XIN = "countries/Hu Xin.txt"
WUL = "countries/Wulong.txt"
MAK = "countries/Makapu.txt"
NOW = "countries/Northwest.txt"
HAN = "countries/Han Tui.txt"
GAR = "countries/Garsai.txt"
NIX = "countries/East Hu Xin.txt"
YUE = "countries/Yue.txt"
CHN = "countries/Chin.txt"
ZAO = "countries/Zaofu.txt"
SWA = "countries/Foggy Swamp.txt"
MPO = "countries/Misty Palms Oasis.txt"
NAN = "countries/Nan Shan.txt"
ZIN = "countries/Tu Zin.txt"
YII = "countries/Yi.txt"
HEB = "countries/Hebai Forest.txt"
ISL = "countries/Islands.txt"
NCB = "countries/North Chameleon Bay.txt"
ECB = "countries/East Chameleon Bay.txt"
EBA = "countries/East Ba.txt"
WBA = "countries/West Ba.txt"
LAM = "countries/Laghima Mountains.txt"
GDD = "countries/Great Divide.txt"
FMB = "countries/Full Moon Bay.txt"
MER = "countries/Merchant.txt"

TEJ = "countries/Teji.txt"

PFC = "countries/Pohuai Fire Colony.txt"
YFC = "countries/Yu Dao Fire Colony.txt"
HFC = "countries/Hu Xin Fire Colony.txt"
KFC = "countries/Han Tui Fire Colony.txt"
MFC = "countries/Makapu Fire Colony.txt"
GFC = "countries/Garsai Fire Colony.txt"
OMC = "countries/New Ozai.txt"

PIR = "countries/Pirates.txt"

SPI = "countries/Spirit Realm.txt"
GIF = "countries/Genocide Invasion Force.txt"

BHA = "countries/Bhanti.txt"
KEO = "countries/Keohso.txt"
SEI = "countries/Seinaka.txt"
SAO = "countries/Saowan.txt"
INT = "countries/Inta.txt"
LAH = "countries/Lahaisin.txt"
MAN = "countries/Manda.txt"
FAR = "countries/Fire Army.txt"

PEF = "countries/Peasants Fire.txt"
PEE = "countries/Peasants Earth.txt"
PEW = "countries/Peasants Water.txt"
PEA = "countries/Peasants Air.txt"
PEG = "countries/Peasants Generic.txt"



##### NEW

ANP = "countries/Anpu.txt"
AOT = "countries/Aotou.txt"
BAI = "countries/Baichuan.txt"
BIN = "countries/Binwu.txt"
CAO = "countries/Caolou.txt"
DAW = "countries/Dawa.txt"
DIN = "countries/Dingcuo.txt"
FUJ = "countries/Fujian.txt"
FUN = "countries/Fung.txt"
GAS = "countries/Gashun.txt"
GOU = "countries/Goutou.txt"
KEY = "countries/Keyu.txt"
PEN = "countries/Penglai.txt"
REX = "countries/Rexi.txt"
SHE = "countries/Shendu.txt"
TAN = "countries/Tangjia.txt"
TIG = "countries/Tigu.txt"
TUM = "countries/Tumuzhen.txt"
WAI = "countries/Waigou.txt"
WAO = "countries/Wao'ao.txt"
XIL = "countries/Xili.txt"
YON = "countries/Yontai.txt"